术语翻译注释 (Terminology Translation Notes):

    游戏机制相关:

        гексагон → 六边形 (Hexagon, 指六边形领土单位)

        чанк → 区块 (Minecraft 标准术语)

        приватный чанк → 私有区块 (玩家私人领地)

        аутпост → 前哨站 (城市外围领地)

    行政单位:

        город → 城市

        нация → 国家

        столица → 首都

        внешние владения → 外部属地

    职位头衔:

        мэр → 市长

        лидер → 领袖

        ассистенты → 助手

        министры → 部长

    经济系统:

        казна → 国库

        налоги → 税收

        незерит → 下界合金 (Netherite)

        пол-алмаза → 半颗钻石

    交互提示:

        телепорт → 传送

        спавн → 出生点

        домен → 主城区

        пустошь → 荒野

    状态提示:

        уровень доступа → 访问权限等级

        коррупция → 腐败

        банкротство → 破产

    特殊格式:

        保留 <color> 标签格式

        %VAR% 变量占位符保持原格式